//MAP CONVERTED BY dmm2tgm.py THIS HEADER COMMENT PREVENTS RECONVERSION, DO NOT REMOVE
"a" = (
/turf/space,
/area/space)
"z" = (
/obj/landmark/spawnpoint/new_player,
/turf/unsimulated/start_area,
/area/misc/start)
"Y" = (
/turf/unsimulated/start_area,
/area/misc/start)
"Z" = (
/turf/simulated/splashscreen,
/area/misc/start)

(1,1,1) = {"
a
a
a
a
a
a
a
a
a
a
Y
Y
Y
Y
Y
Y
Y
Y
Y
Y
Y
Y
Y
Y
Z
"}
(2,1,1) = {"
a
a
a
a
a
a
a
a
a
a
Y
Y
Y
Y
Y
Y
Y
Y
Y
Y
Y
Y
Y
Y
Y
"}
(3,1,1) = {"
a
a
a
a
a
a
a
a
a
a
Y
Y
Y
Y
Y
Y
Y
Y
Y
Y
Y
Y
Y
Y
Y
"}
(4,1,1) = {"
a
a
a
a
a
a
a
a
a
a
Y
Y
Y
Y
Y
Y
Y
Y
Y
Y
Y
Y
Y
Y
Y
"}
(5,1,1) = {"
a
a
a
a
a
a
a
a
a
a
Y
Y
Y
Y
Y
Y
Y
Y
Y
Y
Y
Y
Y
Y
Y
"}
(6,1,1) = {"
a
a
a
a
a
a
a
a
a
a
Y
Y
Y
Y
Y
Y
Y
Y
Y
Y
Y
Y
Y
Y
Y
"}
(7,1,1) = {"
a
a
a
a
a
a
a
a
a
a
Y
Y
Y
Y
Y
Y
Y
Y
Y
Y
Y
Y
Y
Y
Y
"}
(8,1,1) = {"
a
a
a
a
a
a
a
a
a
a
Y
Y
Y
Y
Y
Y
Y
z
Y
Y
Y
Y
Y
Y
Y
"}
(9,1,1) = {"
a
a
a
a
a
a
a
a
a
a
Y
Y
Y
Y
Y
Y
Y
Y
Y
Y
Y
Y
Y
Y
Y
"}
(10,1,1) = {"
a
a
a
a
a
a
a
a
a
a
Y
Y
Y
Y
Y
Y
Y
Y
Y
Y
Y
Y
Y
Y
Y
"}
(11,1,1) = {"
a
a
a
a
a
a
a
a
a
a
Y
Y
Y
Y
Y
Y
Y
Y
Y
Y
Y
Y
Y
Y
Y
"}
(12,1,1) = {"
a
a
a
a
a
a
a
a
a
a
Y
Y
Y
Y
Y
Y
Y
Y
Y
Y
Y
Y
Y
Y
Y
"}
(13,1,1) = {"
a
a
a
a
a
a
a
a
a
a
Y
Y
Y
Y
Y
Y
Y
Y
Y
Y
Y
Y
Y
Y
Y
"}
(14,1,1) = {"
a
a
a
a
a
a
a
a
a
a
Y
Y
Y
Y
Y
Y
Y
Y
Y
Y
Y
Y
Y
Y
Y
"}
(15,1,1) = {"
a
a
a
a
a
a
a
a
a
a
Y
Y
Y
Y
Y
Y
Y
Y
Y
Y
Y
Y
Y
Y
Y
"}
(16,1,1) = {"
a
a
a
a
a
a
a
a
a
a
Y
Y
Y
Y
Y
Y
Y
Y
Y
Y
Y
Y
Y
Y
Y
"}
(17,1,1) = {"
a
a
a
a
a
a
a
a
a
a
Y
Y
Y
Y
Y
Y
Y
Y
Y
Y
Y
Y
Y
Y
Y
"}
(18,1,1) = {"
a
a
a
a
a
a
a
a
a
a
a
a
a
a
a
a
a
a
a
a
a
a
a
a
a
"}
(19,1,1) = {"
a
a
a
a
a
a
a
a
a
a
a
a
a
a
a
a
a
a
a
a
a
a
a
a
a
"}
(20,1,1) = {"
a
a
a
a
a
a
a
a
a
a
a
a
a
a
a
a
a
a
a
a
a
a
a
a
a
"}
(21,1,1) = {"
a
a
a
a
a
a
a
a
a
a
a
a
a
a
a
a
a
a
a
a
a
a
a
a
a
"}
(22,1,1) = {"
a
a
a
a
a
a
a
a
a
a
a
a
a
a
a
a
a
a
a
a
a
a
a
a
a
"}
(23,1,1) = {"
a
a
a
a
a
a
a
a
a
a
a
a
a
a
a
a
a
a
a
a
a
a
a
a
a
"}
(24,1,1) = {"
a
a
a
a
a
a
a
a
a
a
a
a
a
a
a
a
a
a
a
a
a
a
a
a
a
"}
(25,1,1) = {"
a
a
a
a
a
a
a
a
a
a
a
a
a
a
a
a
a
a
a
a
a
a
a
a
a
"}
